hbo	Meta	en	Comment
א	Alef	'
אּ	Alef	'
ב	Bet	v
בּ	Bet	b
בָּ		bbā	# Qamats is (wrongly?) BEFORE dagesh
בִּ		bbi	# Hiriq is (wrongly?) BEFORE dagesh
בֹּ		bbo	# Holam is (wrongly?) BEFORE dagesh
ג	Gimel	g
גּ	Gimel	g
גָּ		ggā	# Qamats is (wrongly?) BEFORE dagesh
גֵּ		ggē	# Tsere is (wrongly?) BEFORE dagesh
גֹּ		ggo	# Holam is (wrongly?) BEFORE dagesh
גֻּ		ggu	# Qubuts is (wrongly?) BEFORE dagesh
ד	Dalet	d
דּ	Dalet	d
דַּ		dda	# Patah is (wrongly?) BEFORE dagesh
דָּ		ddā	# Qamats is (wrongly?) BEFORE dagesh
דֵּ		ddē	# Tsere is (wrongly?) BEFORE dagesh
ה	He	h
הּ	HeFinal	h
ו	Vav	v
וֹ		ō
וּ		ū
וָּ		vvā	# Qamats is (wrongly?) BEFORE dagesh
ז	Zayin	z
זּ	Zayin	zz
זִּ		zzi	# Hiriq is (wrongly?) BEFORE dagesh
ח	Het	ḩ
חּ	Het	ḩḩ
ט	Tet	ţ
טּ	Tet	ţţ
טָּ		ţţā	# Qamats is (wrongly?) BEFORE dagesh
י	Yod	y
יּ	Yod	u
יָּ		yyā	# Qamats is (wrongly?) BEFORE dagesh
כ	Kaf	k
כּ	Kaf	k
כִּ		kki	# Hiriq is (wrongly?) BEFORE dagesh
כִּי		kkī	# Hiriq is (wrongly?) BEFORE dagesh BEFORE YOD
ך	KafFinal	k
ךּ	KafFinal	k
ל	Lamed	l
לּ	Lamed	ll
מ	Mem	m
מּ	Mem	mm
מָּ		mmā	# Qamats is (wrongly?) BEFORE dagesh
מֶּ		mme	# Segol is (wrongly?) BEFORE dagesh
מִּ		mmi	# Hiriq is (wrongly?) BEFORE dagesh
ם	MemFinal	m
נ	Nun	n
נּ	Nun	nn
נֹּ		nno	# Holam is (wrongly?) BEFORE dagesh
ן	NunFinal	n
ס	Samekh	ş
סּ	Samekh	şş
ע	Ayin	'
פ	Pe	f
פּ	Pe	p
פַּ		ppa	# Patah is (wrongly?) BEFORE dagesh
ף	PeFinal	f
ףּ	PeFinal	p
צ	Tsadi	ʦ
צּ	Tsadi	ʦʦ
ץ	TsadiFinal	ʦ
ק	Qof	q
קּ	Qof	qq
ר	Resh	r
רּ	Resh	rr
ש	Shin	sh
שְׁ		shə	# Sheva is (wrongly?) BEFORE shin dot
שַׁ		sha	# Patah is (wrongly?) BEFORE shin dot
שָׁ		shā	# Qamats is (wrongly?) BEFORE shin dot
שֶׁ		she	# Segol is (wrongly?) BEFORE shin dot
שֵׁ		shē	# Tsere is (wrongly?) BEFORE shin dot
שִׁ		shi	# Hiriq is (wrongly?) BEFORE shin dot
שֹׁ		sho	# Holam is (wrongly?) BEFORE shin dot
שֶּׁ		shshe	# Segol is (wrongly?) BEFORE dagesh which is BEFORE shin dot
שְׂ		sə	# Sheva is (wrongly?) BEFORE sin dot
שַׂ		sa	# Patah is (wrongly?) BEFORE sin dot
שָׂ		sā	# Qamats is (wrongly?) BEFORE sin dot
שֶׂ		se	# Segol is (wrongly?) BEFORE sin dot
שׁ	Shin	sh
שׁ	Shin	sh
שּׁ	Shin	shsh
שׂ	Sin	s
שׂ	Sin	s
שּׂ	Sin	ss
ת	Tav	t
תּ	Tav	t
תַּ		tta	# Patah is (wrongly?) BEFORE dagesh
תָּ		ttā	# Qamats is (wrongly?) BEFORE dagesh
תֶּ		tte	# Segol is (wrongly?) BEFORE dagesh
תִּ		tti	# Hiriq is (wrongly?) BEFORE dagesh
ְ	Sheva	ə
ַ	Patah	a
ָ	Qamats	ā
ׇ	QamatsQatan	ā
ֿ	Rafe
ֶ	Segol	e
ֲ	HatafPatah	a
ֳ	HatafQamats	a
ֱ	HatafSegol	e
ֵ	Tsere	ē
ִ	Hiriq	i
ִי	HiriqYod	ī	# This may not be a good solution -- only applies if the yod doesn't have it's own pointing
ֹ	Holam	o
ֺ	HolamHaserForVav	o
ֻ	Qubuts	u
־	Maqaf	-
ֽ	Meteg
׀	Paseq
׆	NunHafukha	[
ׅ	LowerDot
ׄ	UpperDot
֧	DargaAccent
֭	DehiAccent
֑	EtnahtaAccent
֜	GereshAccent
֝	GereshMuqdamAccent
֞	GershayimAccent
֬	IluyAccent
֤	MahapakhAccent
֥	MerkhaAccent
֦	MerkhaKefulaAccent
֣	MunahAccent
֫	OleAccent
֙	PashtaAccent
֡	PazerAccent
֨	QadmaAccent
֟	QarneyParaAccent
֗	ReviaAccent
֒	SegolAccent
֓	ShaksheletAccent
֠	TelishaGedolaAccent
֩	TelishaQetanaAccent
֛	TevirAccent
֖	TipehaAccent
֪	YerahBenYomoAccent
֚	YetivAccent
֕	ZaqefGadolAccent
֔	ZaqefQatanAccent
֘	ZarqaAccent
֮	ZinorAccent
׃	SofPasuq	.
